공급위치,아파트명,건설사,전용면적,분양가격,지역,세부지역,평,평당 분양가격,평당 예측가격,평당 분양-예측,평당 분양/예측%,예측가격,분양-예측,분양/예측%
강원도 강릉시 포남동 1117외 5필지, KTX강릉역 동도센트리움, 동도건설(주),59.99,287000000,강원도,강릉시,18.18,15786579,12683849,3102730,124,230592375,56407625,124
강원도 원주시 c4블럭, 원주혁신도시 제일풍경채 센텀포레, 제일건설(주),91.4,323700000,강원도,원주시,27.7,11685921,11086345,599576,105,307091756,16608244,105
강원도 원주시 c4블럭, 원주혁신도시 제일풍경채 센텀포레, 제일건설(주),110.58,391500000,강원도,원주시,33.51,11683080,11698000,-14920,100,391999980,-499980,100
강원도 속초시 우렁3길 20 (동명동), 속초 롯데캐슬 인더스카이, 롯데건설(주),79.94,403150000,강원도,속초시,24.22,16645334,11420491,5224843,146,276604292,126545708,146
강원도 속초시 우렁3길 20 (동명동), 속초 롯데캐슬 인더스카이, 롯데건설(주),84.98,466370000,강원도,속초시,25.75,18111456,11375982,6735474,159,292931536,173438464,159
강원도 평창군 대관령면 횡계리 335-8 외2필지, 대관령 현대힐스 700, 현대아산 주식회사,62.79,289600000,강원도,평창군,19.03,15218077,13121892,2096185,116,249709605,39890395,116
강원도 속초시 장안로4길 40 (동명동), 속초디오션자이, 지에스건설(주),84.97,485000000,강원도,속초시,25.75,18834951,11375982,7458969,166,292931536,192068464,166
강원도 속초시 조양동 415번지, 속초2차 아이파크, HDC현대산업개발,79.36,294900000,강원도,속초시,24.05,12261954,11215806,1046148,109,269740134,25159866,109
강원도 속초시 조양동 415번지, 속초2차 아이파크, HDC현대산업개발,84.92,318800000,강원도,속초시,25.73,12390206,11816801,573405,105,304046290,14753710,105
강원도 평창군 봉평면 안흥동1길 25-4, 평창 엘리엇아파트, 에이치아이건설 주식회사,59.55,183000000,강원도,평창군,18.05,10138504,13237710,-3099206,77,238940666,-55940666,77
경상남도 남해군 남해읍 아산리 388-1, 남해스타펠레스,동원건설산업(주),79.38,252000000,경상남도,남해군,24.05,10478170,9271637,1206533,113,222982870,29017130,113
경상남도 밀양시 내이동 133번지, e편한세상 밀양 나노밸리, 대림산업 주식회사,66.97,253300000,경상남도,밀양시,20.29,12483982,10205223,2278759,122,207063975,46236025,122
경상남도 밀양시 내이동 133번지, e편한세상 밀양 나노밸리, 대림산업 주식회사,84.93,297420000,경상남도,밀양시,25.74,11554779,9797622,1757157,118,252190790,45229210,118
경상남도 김해시 안동 360-1, 김해 푸르지오 하이엔드,(주)대우건설,59.76,279000000,경상남도,김해시,18.11,15405853,12670912,2734941,122,229470216,49529784,122
경상남도 김해시 안동 360-1, 김해 푸르지오 하이엔드,(주)대우건설,74.88,342000000,경상남도,김해시,22.69,15072719,12173506,2899213,124,276216851,65783149,124
경상남도 김해시 안동 360-1, 김해 푸르지오 하이엔드,(주)대우건설,84.99,384000000,경상남도,김해시,25.75,14912621,12972226,1940395,115,334034820,49965180,115
경상남도 양산시 물금읍 범어리 409, 양산물금 브라운스톤, 이수건설주식회사,72.76,315440000,경상남도,양산시,22.05,14305669,11024217,3281452,130,243083985,72356015,130
경상남도 양산시 동면 양산사송택지개발지구, 사송더샵데시앙2차(B-7BL), (주)태영건설,84.93,372000000,경상남도,양산시,25.74,14452214,11937476,2514738,121,307270632,64729368,121
경상남도 양산시 동면 양산사송택지개발지구, 사송더샵데시앙2차(B-5BL), (주)태영건설,84.93,376000000,경상남도,양산시,25.74,14607615,11937476,2670139,122,307270632,68729368,122
경상남도 양산시 동면 양산사송택지개발지구, 사송더샵데시앙2차(B-6BL), (주)태영건설,84.93,370000000,경상남도,양산시,25.74,14374514,11937476,2437038,120,307270632,62729368,120
경상남도 창원성산구 사파정동 117, 창원 성산 반도유보라 아이비파크, (주)반도건설,78.95,458000000,경상남도,창원성산구,23.92,19147157,10370938,8776219,185,248072837,209927163,185
경상남도 김해시 삼문동 1069, 이안 센트럴포레 장유 2단지, 대우산업개발(주),59.98,221000000,경상남도,김해시,18.18,12156216,12461545,-305329,98,226550888,-5550888,98
경상남도 김해시 삼문동 903, 이안 센트럴포레 장유 1단지, 대우산업개발(주),59.98,222000000,경상남도,김해시,18.18,12211221,12461545,-250324,98,226550888,-4550888,98
경상남도 창원진해구 남양동 20-2, 창원진해 비전시티 우방아이유쉘, 동아건설산업외1,76.59,237700000,경상남도,창원진해구,23.21,10241275,8330132,1911143,123,193342364,44357636,123
경상북도 칠곡군 북삼읍 인평리 660번지, 칠곡북삼 서희스타힐스 더퍼스트, 서희건설,80.86,201820000,경상북도,칠곡군,24.5,8237551,9418317,-1180766,87,230748766,-28928766,87
경상북도 구미시 야은로43길 13, 성원 상떼빌, 성원건설(주),84.86,229900000,경상북도,구미시,25.72,8938569,11207605,-2269036,80,288259601,-58359601,80
경상북도 경산시 경안로47길 32-18 (중방동), 경산 서희스타힐스, (주)서희건설,59.99,330000000,경상북도,경산시,18.18,18151815,14883803,3268012,122,270587539,59412461,122
경상북도 문경시 문경읍 하리 346번지, 문경역 지엘리베라움 더 퍼스트, 지엘건설(주),84.97,239800000,경상북도,문경시,25.75,9312621,11192422,-1879801,83,288204866,-48404866,83
경상북도 경산시 삼성현로91길 10, 경산 사동 팰리스 부영2단지, (주)부영주택,84.98,268000000,경상북도,경산시,25.75,10407767,13491484,-3083717,77,347405713,-79405713,77
경상북도 문경시 당교3길 16 (모전동), 문경 모전 코아루 노블36, 새천년종합건설 주식회사,80.56,308080000,경상북도,문경시,24.41,12621057,10753861,1867196,117,262501747,45578253,117
경상북도 상주시 동수4길 127 (냉림동), 냉림동 현대 유니언, (주)현대종합건설,84.96,289000000,경상북도,상주시,25.75,11223301,10304406,918895,109,265338454,23661546,109
경상북도 포항북구 두호로 65, 두호 SK VIEW 푸르지오 2단지,SK건설 대우건설,84.99,310900000,경상북도,포항북구,25.75,12073786,11755104,318682,103,302693928,8206072,103
경상북도 포항북구 두호로 66, 두호 SK VIEW 푸르지오 1단지, SK건설 대우건설,84.99,335000000,경상북도,포항북구,25.75,13009709,11755104,1254605,111,302693928,32306072,111
광주광역시 북구 임유길13번길 1 (임동), 금남로 중흥S-클래스&두산위브더제니스, 두산건설(주),59.78,347000000,광주광역시,북구,18.12,19150110,13259795,5890315,144,240267485,106732515,144
광주광역시 북구 임유길13번길 1 (임동), 금남로 중흥S-클래스&두산위브더제니스, 두산건설(주),76.82,465000000,광주광역시,북구,23.28,19974227,14335542,5638685,139,333731418,131268582,139
광주광역시 북구 임유길13번길 1 (임동), 금남로 중흥S-클래스&두산위브더제니스, 두산건설(주),84.96,512000000,광주광역시,북구,25.75,19883495,11722056,8161439,170,301842942,210157058,170
광주광역시 동구 산수동 16-1, 무등산 명지 로드힐, (유)명지건설,74.13,325000000,광주광역시,동구,22.46,14470169,17359855,-2889686,83,389902343,-64902343,83
광주광역시 광산구 어등대로647번길 41 (소촌동), 힐스테이트 광산, 현대엔지니어링㈜,84.92,376300000,광주광역시,광산구,25.73,14624951,14559960,64991,100,374627771,1672229,100
광주광역시 동구 학소로42번길 40 (소태동), e편한세상 무등산, 고려개발(주),84.95,466700000,광주광역시,동구,25.74,18131313,17776607,354706,102,457569864,9130136,102
광주광역시 북구 동문대로249번길 13 (문흥동), 더샵 광주포레스트, (주)포스코건설,84.99,476000000,광주광역시,북구,25.75,18485437,11722056,6763381,158,301842942,174157058,158
광주광역시 북구 동문대로249번길 13 (문흥동), 더샵 광주포레스트, (주)포스코건설,101.99,638000000,광주광역시,북구,30.91,20640569,15347860,5292709,134,474402353,163597647,134
광주광역시 동구 충장로 5가 96-4 외, 충장 로머스파크 헤리티지 주상복합 아파트, (주)천마종합건설,59.96,340400000,광주광역시,동구,18.17,18734177,16702839,2031338,112,303490585,36909415,112
광주광역시 북구 동문대로266번길 27 (각화동), 무등산 한국아델리움 어반센트럴, 한국건설(주),84.21,408000000,광주광역시,북구,25.52,15987461,16084844,-97383,99,410485219,-2485219,99
대구광역시 수성구 중동 556번지, 수성 푸르지오 리버센트, (주)대우건설,84.99,655000000,대구광역시,수성구,25.75,25436893,33104505,-7667612,77,852441004,-197441004,77
대구광역시 수성구 중동 556번지, 수성 푸르지오 리버센트, (주)대우건설,110.99,860000000,대구광역시,수성구,33.63,25572406,27420198,-1847792,93,922141259,-62141259,93
대구광역시 서구 원대동 1401번지, 서대구센트럴자이, 지에스건설(주),59.82,384500000,대구광역시,서구,18.13,21207943,15257927,5950016,139,276626217,107873783,139
대구광역시 서구 원대동 1401번지, 서대구센트럴자이, 지에스건설(주),74.93,451300000,대구광역시,서구,22.71,19872303,13493714,6378589,147,306442245,144857755,147
대구광역시 서구 원대동 1401번지, 서대구센트럴자이, 지에스건설(주),84.97,519400000,대구광역시,서구,25.75,20170874,11061367,9109507,182,284830200,234569800,182
대구광역시 수성구 용학로 189, 더샵 수성라크에르, (주)포스코건설,59.84,428100000,대구광역시,수성구,18.13,23612796,32749885,-9137089,72,593755415,-165655415,72
대구광역시 달성군 화원읍 설화리 975번지, 화원신일해피트리꿈의숲, (주)신일,69.84,324900000,대구광역시,달성군,21.16,15354442,12471898,2882544,123,263905362,60994638,123
대구광역시 남구 대봉로32길 7-26 (이천동), 대봉교역 태왕아너스, (주)태왕이앤씨,59.99,386000000,대구광역시,남구,18.18,21232123,17740459,3491664,120,322521545,63478455,120
대구광역시 북구 칠성남로2길 173 (고성동1가) 55-2, 대구오페라스위첸, (주)KCC건설,84.92,565600000,대구광역시,북구,25.73,21982122,16786463,5195659,131,431915693,133684307,131
대구광역시 중구 달성로 67 (대신동), 청라힐 지웰 더 센트로, 신영건설 주식회사,72.7,470000000,대구광역시,중구,22.03,21334544,20680163,654381,103,455583991,14416009,103
대구광역시 동구 신암동 255-14번지, 동대구역 화성파크드림, 화성산업(주),84.81,564000000,대구광역시,동구,25.7,21945525,15583505,6362020,141,400496078,163503922,141
대구광역시 달서구 감삼동 567-1번지 외 11필지, 해링턴 플레이스 감삼Ⅱ(2차), (주)효성중공업,84.96,644800000,대구광역시,달서구,25.75,25040777,12937291,12103486,194,333135243,311664757,194
대구광역시 서구 국채보상로37길 36-7 (평리동), 서대구역 서한이다음 더 퍼스트, 주식회사 서한,76.91,421000000,대구광역시,서구,23.31,18060918,12001103,6059815,150,279745711,141254289,150
대전광역시 유성구 용산동 371-2번지, 대전 용산지구 1BL 호반써밋 그랜드파크, (주)호반건설,84.97,424400000,대전광역시,유성구,25.75,16481553,47712701,-31231148,35,1228602051,-804202051,35
대전광역시 유성구 용산동 390번지, 대전 용산지구 3BL 호반써밋 그랜드파크, (주)호반건설,84.97,424600000,대전광역시,유성구,25.75,16489320,47712701,-31223381,35,1228602051,-804002051,35
대전광역시 유성구 둔곡길 218 (둔곡동), 대전 둔곡지구 A3BL 우미린, (주)우미개발,68.52,268300000,대전광역시,유성구,20.76,12923892,23690623,-10766731,55,491817333,-223517333,55
대전광역시 유성구 둔곡길 218 (둔곡동), 대전 둔곡지구 A3BL 우미린, (주)우미개발,84.94,329600000,대전광역시,유성구,25.74,12804973,36531932,-23726959,35,940331930,-610731930,35
대전광역시 동구 동산초교로 23-3외 6필지, 홍도동 다우 갤러리휴리움, 다우건설주식회사,59.99,264000000,대전광역시,동구,18.18,14521452,18866420,-4344968,77,342991516,-78991516,77
대전광역시 동구 동서대로1748번길 25-1, 가양동 고운하이플러스, 고운건설(주),59.59,266100000,대전광역시,동구,18.06,14734219,16575490,-1841271,89,299353349,-33253349,89
대전광역시 유성구 둔곡지구 A-2블럭, 유성둔곡지구 서한이다음(2단지), (주)서한,84.96,319000000,대전광역시,유성구,25.75,12388350,47712701,-35324351,26,1228602051,-909602051,26
대전광역시 유성구 둔곡지구 A-1블럭, 유성둔곡지구 서한이다음(1단지), (주)서한,59.65,240000000,대전광역시,유성구,18.08,13274336,19265111,-5990775,69,348313207,-108313207,69
부산광역시 연제구 거제동 802번지, 레이카운티, 삼성물산(주) 대림산업(주) 에이치디씨현대산업개발(주),59.98,479000000,부산광역시,연제구,18.18,26347635,21089023,5258612,125,383398438,95601562,125
부산광역시 연제구 거제동 802번지, 레이카운티, 삼성물산(주) 대림산업(주) 에이치디씨현대산업개발(주),84.98,710000000,부산광역시,연제구,25.75,27572816,20477486,7095330,135,527295264,182704736,135
부산광역시 영도구 동삼동 383-1번지, 오션라이프 에일린의 뜰 2단지, 아이에스동서주식회사,74.96,407400000,부산광역시,영도구,22.72,17931338,13963984,3967354,128,317261716,90138284,128
부산광역시 영도구 동삼동 383-1번지, 오션라이프 에일린의 뜰 2단지, 아이에스동서주식회사,84.93,458400000,부산광역시,영도구,25.74,17808858,14465599,3343259,123,372344518,86055482,123
부산광역시 영도구 동삼동383-1번지, 오션라이프 에일린의 뜰 1단지, 아이에스동서주식회사,74.96,393100000,부산광역시,영도구,22.72,17301937,13963984,3337953,124,317261716,75838284,124
부산광역시 영도구 동삼동383-1번지, 오션라이프 에일린의 뜰 1단지, 아이에스동서주식회사,84.93,441200000,부산광역시,영도구,25.74,17140637,14465599,2675038,118,372344518,68855482,118
부산광역시 남구 천제등로28번길 64 (대연동), 대연 푸르지오 클라센트, (주)대우건설,59.96,421200000,부산광역시,남구,18.17,23181068,23346153,-165085,99,424199600,-2999600,99
부산광역시 남구 천제등로28번길 64 (대연동), 대연 푸르지오 클라센트, (주)대우건설,74.91,489400000,부산광역시,남구,22.7,21559471,13941519,7617952,155,316472481,172927519,155
부산광역시 사상구 괘법동 550-2, 사상역 봄여름가을겨울, (주)주원종합건설,70.23,342700000,부산광역시,사상구,21.28,16104323,14825574,1278749,109,315488215,27211785,109
울산광역시 남구 신정동 1178번지, 문수로대공원 에일린의 뜰, 아이에스동서주식회사,59.71,489640000,울산광역시,남구,18.09,27066888,22357314,4709574,121,404443810,85196190,121
울산광역시 중구 복산동 460-72, 번영로 센트리지, 현대엔지니어링㈜ 롯데건설㈜ 효성중공업㈜ 진흥기업㈜,59.86,425800000,울산광역시,중구,18.14,23472988,17330046,6142942,135,314367034,111432966,135
울산광역시 중구 복산동 460-72, 번영로 센트리지, 현대엔지니어링㈜ 롯데건설㈜ 효성중공업㈜ 진흥기업㈜,75.91,491700000,울산광역시,중구,23.0,21378261,11905368,9472893,180,273823464,217876536,180
울산광역시 중구 복산동 460-72, 번영로 센트리지, 현대엔지니어링㈜ 롯데건설㈜ 효성중공업㈜ 진흥기업㈜,84.92,549500000,울산광역시,중구,25.73,21356393,12248228,9108165,174,315146906,234353094,174
울산광역시 남구 팔등로 4 (신정동), 문수로 드림파크, 드림종합건설(주),51.69,241000000,울산광역시,남구,15.66,15389527,18440926,-3051399,83,288784901,-47784901,83
울산광역시 남구 신화로 18, 더샵 번영센트로, (주)포스코건설,59.98,451000000,울산광역시,남구,18.18,24807481,18913895,5893586,131,343854611,107145389,131
울산광역시 남구 신화로 18, 더샵 번영센트로, (주)포스코건설,84.87,620200000,울산광역시,남구,25.72,24113530,18382535,5730995,131,472798800,147401200,131
울산광역시 북구 중산동 1276번지, 오토밸리 한양립스 포레스트, (주)한양건설,59.92,237000000,울산광역시,북구,18.16,13050661,18655041,-5604380,70,338775545,-101775545,70
울산광역시 남구 수암로190번길 17, 울산대현 시티프라디움, (주)시티종합건설,84.35,633700000,울산광역시,남구,25.56,24792645,13954710,10837935,178,356682388,277017612,178
울산광역시 중구 당산4길 12 (우정동), 태화강 유보라 팰라티움, 주식회사 반도건설,84.93,522430000,울산광역시,중구,25.74,20296426,15985465,4310961,127,411465869,110964131,127
울산광역시 남구 여천로5번길 46, 번영로 하늘채 센트럴파크, 코오롱글로벌(주),59.91,385000000,울산광역시,남구,18.15,21212121,21779205,-567084,97,395292571,-10292571,97
울산광역시 동구 서부동 248-37, 울산 지웰시티 자이 2단지, 지에스건설 (주),84.99,468400000,울산광역시,동구,25.75,18190291,13542206,4648085,134,348711804,119688196,134
울산광역시 동구 서부동 257번지, 울산 지웰시티 자이 1단지, 지에스건설 (주),84.99,461700000,울산광역시,동구,25.75,17930097,13542206,4387891,132,348711804,112988196,132
인천광역시 중구 중산동 1871-4(영종국제도시 A31BL), 영종국제도시 동원로얄듀크(A31BL), (주)동원개발,84.98,411700000,인천광역시,중구,25.75,15988350,13694239,2294111,117,352626654,59073346,117
인천광역시 부평구 후정로 6-1 (삼산동), 브라운스톤 부평, 이수건설(주),59.99,369500000,인천광역시,부평구,18.18,20324532,17623977,2700555,115,320403902,49096098,115
인천광역시 미추홀구 도화동 377-1, 주안역 미추홀 더리브, 주식회사 이테크건설,84.83,454400000,인천광역시,미추홀구,25.71,17674057,10341260,7332797,171,265873795,188526205,171
인천광역시 중구 운남동 1598-1, 운서2차 SK VIEW Skycity A7블럭, SK건설(주),78.77,388040000,인천광역시,중구,23.87,16256389,12562591,3693798,129,299869047,88170953,129
인천광역시 중구 운남동 1598-1, 운서2차 SK VIEW Skycity A7블럭, SK건설(주),84.91,406380000,인천광역시,중구,25.73,15794015,12119471,3674544,130,311833989,94546011,130
인천광역시 미추홀구 주안동 830번지, 주안파크자이 더 플래티넘, 지에스건설(주) 쌍용건설(주),59.95,433500000,인천광역시,미추홀구,18.17,23858008,11075753,12782255,215,201246432,232253568,215
인천광역시 미추홀구 주안동 830번지, 주안파크자이 더 플래티넘, 지에스건설(주) 쌍용건설(주),73.95,488500000,인천광역시,미추홀구,22.41,21798304,10532868,11265436,207,236041572,252458428,207
인천광역시 미추홀구 주안동 830번지, 주안파크자이 더 플래티넘, 지에스건설(주) 쌍용건설(주),84.82,541000000,인천광역시,미추홀구,25.7,21050584,11314409,9736175,186,290780311,250219689,186
인천광역시 서구 열우물로240번길 17, 가재울역 트루엘 에코시티,  일성건설(주),49.41,337800000,인천광역시,서구,14.97,22565130,11630623,10934507,194,174110426,163689574,194
인천광역시 부평구 부흥북로 89, 인천 부평 우미린, 우미건설(주),59.97,413000000,인천광역시,부평구,18.17,22729774,16808850,5920924,135,305416804,107583196,135
인천광역시 연수구 송도동 397-5번지, 힐스테이트 레이크 송도 3차, 현대건설(주),84.54,792030000,인천광역시,연수구,25.62,30914520,21063277,9851243,147,539641157,252388843,147
인천광역시 연수구 송도동 397-5번지, 힐스테이트 레이크 송도 3차, 현대건설(주),99.89,891920000,인천광역시,연수구,30.27,29465477,22297475,7168002,132,674944568,216975432,132
전라남도 순천시 저전동 228-3, 저전동 오네뜨 트윈시티, 성암토건(주),80.15,289500000,전라남도,순천시,24.29,11918485,15297034,-3378549,78,371564956,-82064956,78
전라남도 순천시 서면 선평리 337-3번지, 포레나 순천, (주)한화건설,84.95,327000000,전라남도,순천시,25.74,12703963,16344945,-3640982,78,420718884,-93718884,78
전라남도 광양시 마동 와우 도시개발사업지구 A-1블럭, 광양 동문굿모닝힐 맘시티, 동문건설(주),84.96,327000000,전라남도,광양시,25.75,12699029,10629643,2069386,119,273713307,53286693,119
전라남도 함평군 함평읍 기각리 379-10, 함평 한국아델리움 더퍼스트, 한국건설 주식회사,74.99,249000000,전라남도,함평군,22.72,10959507,7580860,3378647,145,172237139,76762861,145
전라남도 광양시 성황·도이 도시개발사업지구 L-2블록, 광양센트럴자이, GS건설(주),84.99,337000000,전라남도,광양시,25.75,13087379,10629643,2457736,123,273713307,63286693,123
전라남도 여수시 쌍봉로 208 (신기동), 여수 신기 휴스티지 아파트, 대창기업(주),84.6,385500000,전라남도,여수시,25.64,15035101,16794274,-1759173,90,430605185,-45105185,90
전라남도 함평군 함평읍 내교리 582, 함평 백년가, 주식회사 애가건설,84.85,273000000,전라남도,함평군,25.71,10618436,7795483,2822953,136,200421868,72578132,136
전라남도 여수시 신기동 8-1번지 외 38번지, 신기동 대광로제비앙 센텀29, 주식회사 대광건영,84.96,448000000,전라남도,여수시,25.75,17398058,16230856,1167202,107,417944542,30055458,107
전라남도 순천시 서면 선평리 613번지, 순천금호어울림더파크2차, 금호산업(주),84.98,309200000,전라남도,순천시,25.75,12007767,16046758,-4038991,75,413204018,-104004018,75
전라남도 순천시 용당동 산175번지, 한양수자인 디에스티지, (주)한양,84.95,328000000,전라남도,순천시,25.74,12742813,16344945,-3602132,78,420718884,-92718884,78
전라북도 완주군 삼례읍 수계리 705, 완주 푸르지오 더 퍼스트, (주)대우건설,72.97,253000000,전라북도,완주군,22.11,11442786,8810221,2632565,130,194793986,58206014,130
전라북도 완주군 삼례읍 수계리 705, 완주 푸르지오 더 퍼스트, (주)대우건설,84.97,287000000,전라북도,완주군,25.75,11145631,9345012,1800619,119,240634059,46365941,119
전라북도 정읍시 상동 산 35-1, 정읍 상동1차 영무예다음, 주식회사 하가건설,84.97,297000000,전라북도,정읍시,25.75,11533981,9687207,1846774,119,249445580,47554420,119
전라북도 정읍시 상동 산 35-1, 정읍 상동1차 영무예다음, 주식회사 하가건설,123.18,420000000,전라북도,정읍시,37.33,11251005,10174823,1076182,111,379826143,40173857,111
전라북도 군산시 나운동 831번지, 나운 금호어울림 센트럴, 금호건설,59.78,196100000,전라북도,군산시,18.12,10822296,12094060,-1271764,89,219144367,-23044367,89
제주특별자치도 제주시 노형동 941-3, 노형 벽강하이본타워 7차, 벽강종합건설(주),76.15,583000000,제주특별자치도,제주시,23.08,25259965,14623177,10636788,173,337502925,245497075,173
제주특별자치도 서귀포시 서홍로 2597, 서홍동 헤리티지, (주)더본종합건설,84.62,437750000,제주특별자치도,서귀포시,25.64,17072933,14287692,2785241,119,366336423,71413577,119
제주특별자치도 제주시 애월읍 고성리 111, 테라시티 더숨, 주식회사대정,99.38,740000000,제주특별자치도,제주시,30.12,24568393,15036318,9532075,163,452893898,287106102,163
제주특별자치도 서귀포시 중산간동로 8027 (동홍동), 서귀포 동홍동 센트레빌, 동부건설(주),84.91,484000000,제주특별자치도,서귀포시,25.73,18810727,13880991,4929736,136,357157898,126842102,136
충청남도 천안동남구 풍세로 678-36 (신방동), 천안 신방 삼부르네상스, 삼부토건(주),59.99,228100000,충청남도,천안동남구,18.18,12546755,13608797,-1062042,92,247407929,-19307929,92
충청남도 천안동남구 풍세로 678-36 (신방동), 천안 신방 삼부르네상스, 삼부토건(주),75.98,291700000,충청남도,천안동남구,23.02,12671590,13453867,-782277,94,309708018,-18008018,94
충청남도 예산군 삽교읍 내포신도시 RM-9블록, 충남내포신도시1차 대방 엘리움 더 퍼스티지(RM9블록), 대방산업개발,75.79,273140000,충청남도,예산군,22.97,11891162,9838293,2052869,121,225985590,47154410,121
충청남도 예산군 삽교읍 내포신도시 RM-9블록, 충남내포신도시1차 대방 엘리움 더 퍼스티지(RM9블록), 대방산업개발,84.97,323230000,충청남도,예산군,25.75,12552621,9880694,2671927,127,254427870,68802130,127
충청남도 천안동남구 청당동 125-1, 행정타운 센트럴 두산위브, 두산건설,74.66,290100000,충청남도,천안동남구,22.62,12824934,13701796,-876862,94,309934626,-19834626,94
충청남도 천안동남구 청당동 125-1, 행정타운 센트럴 두산위브, 두산건설,84.87,327770000,충청남도,천안동남구,25.72,12743779,12451028,292751,102,320240440,7529560,102
충청남도 공주시 금흥동 627, 공주 월송지구 B-1BL 지평더웰, 지평건설(주),84.96,297300000,충청남도,공주시,25.75,11545631,11469373,76258,101,295336355,1963645,101
충청남도 예산군 삽교읍 수암천로 11, 내포신도시 EG the1 2차 공동주택 신축사업, (주)라인건설,84.85,310000000,충청남도,예산군,25.71,12057565,11147653,909912,108,286606159,23393841,108
충청남도 서산시 예천동 480-1, 서산 푸르지오 더 센트럴, (주)대우건설,69.93,262000000,충청남도,서산시,21.19,12364323,10490422,1873901,118,222292042,39707958,118
충청남도 서산시 예천동 480-1, 서산 푸르지오 더 센트럴, (주)대우건설,84.97,339000000,충청남도,서산시,25.75,13165049,11016014,2149035,120,283662360,55337640,120
충청남도 천안서북구 성성동 968, 천안 푸르지오 레이크사이드, (주)대우건설,74.98,379000000,충청남도,천안서북구,22.72,16681338,14165983,2515355,118,321851134,57148866,118
충청남도 천안서북구 성성동 968, 천안 푸르지오 레이크사이드, (주)대우건설,84.98,431000000,충청남도,천안서북구,25.75,16737864,19546906,-2809042,86,503332830,-72332830,86
충청남도 천안동남구 청수동 224번지, 청수행정타운 금호어울림, 금호산업(주),59.87,238200000,충청남도,천안동남구,18.14,13131202,13249026,-117824,99,240337332,-2137332,99
충청남도 당진시 수청동 수청2지구 RH-1블록, 당진수청2 RH1 호반써밋, (주)호반건설,84.84,302300000,충청남도,당진시,25.71,11758071,11602404,155667,101,298297807,4002193,101
충청남도 계룡시 두마면 농소리 971번지(계룡대실지구 1블럭), 계룡 한라비발디 더 센트럴, 주식회사 한라,59.97,222700000,충청남도,계룡시,18.17,12256467,10740942,1515525,114,195162916,27537084,114
충청남도 계룡시 두마면 농소리 971번지(계룡대실지구 1블럭), 계룡 한라비발디 더 센트럴, 주식회사 한라,72.49,278900000,충청남도,계룡시,21.97,12694584,9172637,3521947,138,201522835,77377165,138
충청북도 청주상당구 B-5BL, 청주 동남 파라곤, (주)동양건설산업 (주)라인건설,77.83,281500000,충청북도,청주상당구,23.58,11938083,10972320,965763,109,258727306,22772694,109
충청북도 청주상당구 B-5BL, 청주 동남 파라곤, (주)동양건설산업 (주)라인건설,84.94,303500000,충청북도,청주상당구,25.74,11790987,12364505,-573518,95,318262359,-14762359,95
충청북도 청주상당구 탑동로11번길 40 (탑동), 탑동 힐데스하임, (주)원건설,65.97,294000000,충청북도,청주상당구,19.99,14707354,10399924,4307430,141,207894481,86105519,141
충청북도 청주상당구 탑동로11번길 40 (탑동), 탑동 힐데스하임, (주)원건설,84.84,304000000,충청북도,청주상당구,25.71,11824193,12185572,-361379,97,313291056,-9291056,97
충청북도 청주상당구 탑동로11번길 40 (탑동), 탑동 힐데스하임, (주)원건설,111.96,415000000,충청북도,청주상당구,33.93,12231064,13806574,-1575510,89,468457056,-53457056,89
서울특별시 양천구 신월2동 489-1, 신목동 파라곤, (주)동양건설산업,74.64,663300000,서울특별시,양천구,22.62,29323607,20765580,8558027,141,469717420,193582580,141
서울특별시 강동구 천호동 437-5번지, 힐데스하임 천호, 원건설,84.96,858500000,서울특별시,강동구,25.75,33339806,27287384,6052422,122,702650138,155849862,122
서울특별시 은평구 수색동 189외 162필지, DMC아트포레자이, 지에스건설(주),59.9,527000000,서울특별시,은평구,18.15,29035813,31806278,-2770465,91,577283946,-50283946,91
서울특별시 은평구 수색동 189외 162필지, DMC아트포레자이, 지에스건설(주),84.99,675000000,서울특별시,은평구,25.75,26213592,27287384,-1073792,96,702650138,-27650138,96
서울특별시 은평구 증산동 213-20번지, DMC센트럴자이, 지에스건설(주),84.92,731000000,서울특별시,은평구,25.73,28410416,25502546,2907870,111,656180509,74819491,111
서울특별시 은평구 수색동 115-5번지, DMC파인시티자이, 지에스건설(주),59.98,523000000,서울특별시,은평구,18.18,28767877,31472117,-2704240,91,572163087,-49163087,91
서울특별시 은평구 수색동 115-5번지, DMC파인시티자이, 지에스건설(주),74.84,660000000,서울특별시,은평구,22.68,29100529,21095464,8005065,138,478445124,181554876,138
서울특별시 은평구 수색동 115-5번지, DMC파인시티자이, 지에스건설(주),84.97,721000000,서울특별시,은평구,25.75,28000000,27287384,712616,103,702650138,18349862,103
서울특별시 은평구 수색로20가길 9 (수색동), DMC SK VIEW 아이파크포레, 에스케이건설 주식회사,39.97,360600000,서울특별시,은평구,12.11,29777044,20233192,9543852,147,245023955,115576045,147
서울특별시 강동구 성내동 48-6번지, 힐스테이트 천호역 젠트리스, 현대엔지니어링,84.84,1047800000,서울특별시,강동구,25.71,40754570,23874274,16880296,171,613807585,433992415,171
서울특별시 광진구 자양동 236번지, 롯데캐슬 리버파크 시그니처(자양), 롯데건설(주),59.97,811000000,서울특별시,광진구,18.17,44634012,31964260,12669752,140,580790604,230209396,140
서울특별시 광진구 자양동 236번지, 롯데캐슬 리버파크 시그니처(자양), 롯데건설(주),84.98,1069000000,서울특별시,광진구,25.75,41514563,27287384,14227179,152,702650138,366349862,152
서울특별시 중랑구 면목동 55-14, 용마산 모아엘가 파크포레, 혜림건설주식회사,84.9,611300000,서울특별시,중랑구,25.73,23758259,25502546,-1744287,93,656180509,-44880509,93
서울특별시 노원구 덕릉로102길 5 (상계동), 노원 롯데캐슬 시그니처, 롯데건설(주),59.97,477000000,서울특별시,노원구,18.17,26252064,31964260,-5712196,82,580790604,-103790604,82
서울특별시 노원구 덕릉로102길 5 (상계동), 노원 롯데캐슬 시그니처, 롯데건설(주),84.99,635000000,서울특별시,노원구,25.75,24660194,27287384,-2627190,90,702650138,-67650138,90
경기도 양평군 양평읍 창대리 650-12, 포레나 양평, (주)한화건설,59.78,293500000,경기도,양평군,18.12,16197572,13541073,2656499,120,245364243,48135757,120
경기도 양평군 양평읍 창대리 650-12, 포레나 양평, (주)한화건설,74.99,361900000,경기도,양평군,22.72,15928697,12841210,3087487,124,291752291,70147709,124
경기도 안양동안구 비산동 554-5번지, 비산 한신더휴, 한신공영(주),48.67,407000000,경기도,안양동안구,14.75,27593220,28006127,-412907,99,413090373,-6090373,99
경기도 의정부시 의정부동 238-10번지, 의정부역 스카이자이, 지에스건설주식회사,76.7,506000000,경기도,의정부시,23.24,21772806,13514103,8258703,161,314067754,191932246,161
경기도 파주시 와동동 1411번지, 운정 아이파크 더 테라스, 에이치디씨아이앤콘스,85.91,585700000,경기도,파주시,26.03,22500960,17935503,4565457,125,466861143,118838857,125
경기도 파주시 와동동 1411번지, 운정 아이파크 더 테라스, 에이치디씨아이앤콘스,101.93,637600000,경기도,파주시,30.89,20640984,16624622,4016362,124,513534574,124065426,124
경기도 광주시 삼동 254-38번지, 힐스테이트 삼동역, 현대건설(주),63.99,370000000,경기도,광주시,19.39,19082001,21454046,-2372045,89,415993952,-45993952,89
경기도 광주시 삼동 254-38번지, 힐스테이트 삼동역, 현대건설(주),75.61,422000000,경기도,광주시,22.91,18419904,20006030,-1586126,92,458338147,-36338147,92
경기도 수원영통구 원천동 309번지, 영흥공원 푸르지오 파크비엔, (주)대우건설,77.97,560000000,경기도,수원영통구,23.63,23698688,33506174,-9807486,71,791750892,-231750892,71
경기도 수원영통구 원천동 309번지, 영흥공원 푸르지오 파크비엔, (주)대우건설,84.98,648000000,경기도,수원영통구,25.75,25165049,34096503,-8931454,74,877984952,-229984952,74
경기도 수원영통구 원천동 309번지, 영흥공원 푸르지오 파크비엔, (주)대우건설,117.74,810000000,경기도,수원영통구,35.68,22701794,34199723,-11497929,66,1220246117,-410246117,66
경기도 평택시 고덕국제화계획지구 A-42BL, 고덕신도시 A42BL 제일풍경채3차 센텀, 제일건설(주),75.72,422000000,경기도,평택시,22.95,18387800,14110485,4277315,130,323835631,98164369,130
경기도 평택시 고덕국제화계획지구 A-42BL, 고덕신도시 A42BL 제일풍경채3차 센텀, 제일건설(주),84.9,469000000,경기도,평택시,25.73,18227750,13926087,4301663,131,358318219,110681781,131
경기도 가평군 읍내리 457-5, 가평 센트럴파크 더 스카이, 주식회사 일군토건,74.97,351500000,경기도,가평군,22.72,15470951,10627563,4843388,146,241458231,110041769,146
경기도 양주시 옥정동 869(A-2BL), 양주옥정신도시 3차 노블랜드 에듀포레, 대방건설,75.19,361090000,경기도,양주시,22.78,15851185,16058347,-207162,99,365809145,-4719145,99
경기도 양주시 옥정동 869(A-2BL), 양주옥정신도시 3차 노블랜드 에듀포레, 대방건설,84.85,397980000,경기도,양주시,25.71,15479580,14865947,613633,104,382203497,15776503,104
